BASE 10
HEIGHT 5
START 0
END 0

14 08 07 06 12 07 08 07 01 12
07 09 04 06 08 05 10 09 04 06
10 08 05 14 03 09 07 08 10 08
07 09 04 08 14 06 09 10 06 09
10 08 05 10 08 14 08 07 06 12