 66  10  15   6  10  30  30  10  10  15
 21   2  35  14  15  14 105   3   6  35
 14  15   6   5  42  15  14  35  21   3
  6  70  35   6 105  14   5   6  70  35
 14  10  10  35  14   5   2  70  10 195